职工福利的介绍	职工福利是由公司全额承担费用而给予员工的相关福利待遇。企业为职工提供的除职工工资、奖金、津贴、纳入工资总额管理的补贴、职工教育经费、社会保险费及住房公积金以外的福利待遇支出，包括发放给职工或为职工支付的以下各项现金补贴和非货币性集体福利。
职工福利的项目	职工福利费项目包括：节日活动费、文体活动费、员工大会费、防暑降温费、员工慰问费、驻店员工费用、加班餐费、沟通费、企业文化宣传费、艺术团工作经费、员工健康管理费、交通费用及其他费用等费用项目，餐补、通讯费、交通差旅费、车辆配置、交通补贴、异地补贴、特殊地区津贴、以及安保人员商业保险等费用
节日活动费的介绍	节日活动费是指大型节假日组织礼品发放及聚餐、举办节日特色活动等产生的费用，如礼品采买、食品采买、餐费、活动物资采购费用等。
节日活动费的标准	节日活动费的标准：70元/人/半年，根据上下半年的节日项目有所不同。
春节福利品费的标准	春节福利品费的标准全体门店员工60元/人/年；驻店安保人员额外增加伙食补贴，按所在分部费用标准外，另加30元/人聚餐费；
三八妇女节的福利费使用对象	全三八妇女节的福利费使用对象体自有女员工；
三八妇女节的福利费使用标准	三八妇女节的福利费使用标准：15元/人；
三八妇女节的福利费使用形式	三八妇女节的使用形式：发放日用品等礼品，组织相关活动，如女员工慰问、健康座谈、美容知识分享等活动。不得以现金形式发放。
端午节的福利费使用对象	端午节的使用对象：全体自有员工、正式促销员；
端午节的福利费使用标准	端午节的使用标准：普通员工50元/人，分部及总部高管200元/人；<>备注：驻店防损人员除按所在分部费用标准外，另加30元/人聚餐费;
端午节的福利费使用形式	端午节的使用形式：<>1、礼品发放：采购粽子、鸭蛋等礼品于端午节前发放至员工；<>2、 根据实际情况和当地风俗合理安排端午节特色活动，如包粽子比赛、吃粽子比赛、龙舟比赛等；<>3、 端午节当日，各门店、物流部门的驻店人员、安保人员在完成各项工作交接与安全检查后，经直属领导批准，进行聚餐活动，但需确保不影响次日工作；<>4、不得以现金形式发放。	
中秋节的福利费使用对象	中秋节的使用对象全体自有员工、正式促销员；
中秋节的福利费使用标准	中秋节的使用标准50元/人. <>备注：驻店防损人员除按所在分部费用标准外，另加30元/人聚餐费；高管福利品发放标准可由各大区/分部根据预算情况适当调整，不得超过200
中秋节的福利费使用形式	中秋节的使用形式:<>1、礼品发放：采购月饼等礼品于中秋节前发放至员工；<>2、分部根据实际情况和当地风俗合理安排中秋节特色活动，如灯谜会、趣味游戏、异地员工慰问等；<>3、中秋节当日，各门店、物流部门的驻店人员、安保人员在完成各项工作交接与安全检查后，经直属领导批准，进行聚餐活动，但需确保不影响次日工作；<>4、不得以现金形式发放。
圣诞节的福利费使用对象	圣诞节的使用对象总部各中心，全国各大区、分部、门店；
圣诞节的使用标准	圣诞节的使用标准请点击这里
圣诞节的福利费使用形式	圣诞节的使用形式：圣诞节办公区、门店布置费用（如购买圣诞树，丝带，彩灯等），组织员工活动，如播散甜蜜，互赠祝福卡片等活动。<>备注：其他节日如元旦、教师节、建军节、各地方性节日，各分部可根据实际情况，在预算范围内组织相关活动。
春节福利品费使用对象	春节福利品费使用对象：在岗的所有门店正式员工及正式促销员；总部、大区、分部职能人员不享受此福利。
春节福利品费使用标准	春节福利品费使用标准：60元/人；	
春节福利品费使用形式	春节福利品费使用形式：由各分部自行购买质优的生活用品或食品，在春节前发放至相应员工。不得以现金、购物卡、礼券形式发放。
驻店安保人员春节活动费使用对象	驻店安保人员春节活动费使用对象：各地区分部安保主管（不含）以下在春节期间驻店安保人员，即门店、物流驻店安保人员，以实际在岗人数为准；
驻店安保人员春节活动费使用标准	驻店安保人员春节活动费使用标准：50元/人；
驻店安保人员春节活动费使用形式	驻店安保人员春节活动费使用形式：此笔费用于采购驻店安保人员节日物资或改善伙食所需，不得以现金方式发放或挪用；
生日活动费的介绍	生日活动费是公司为庆祝员工生日发放员工生日礼物、举行集体活动等费用（如茶水/食品/布置物资/宣传制作物/贺卡等费用）
生日活动费的使用对象	生日活动费的使用对象：个人生日礼品发放对象包括自有员工、正式促销员；集体活动以门店为单位进行；
生日活动费的使用标准	生日活动费的使用标准：自有员工及促销员生日礼品标准：50元/人/年；门店生日会活动标准：300元/月/店；分部高管生日礼品发放标准可由各大区/分部根据预算情况适当调整，不得超过200元/人；
生日活动费的使用形式	生日活动费的使用形式：采购日用品或礼品在员工生日当月发放至员工，或定期组织生日会，不得以现金形式发放。
文体活动费费的介绍	文体活动费费的介绍：文艺体育活动、分部大型节促慰问活动、员工联谊、分部动员大会等非节日类活动组织费用（如运动会的场地租赁费、教练费、服装道具费、奖品/奖励费用、茶水/食品费用、布置物资/宣传制作物费用等）；
文体活动费费的使用对象	文体活动费费的使用对象	
文体活动费费的使用标准	文体活动费费的使用标准：文体活动费：70元/人/半年（按照在岗自有员工人数核算）
文体活动费费的使用形式	文体活动费费的使用形式	
动员大会费用介绍	动员大会费用介绍：动员大会费用含在文体活动费中，每年可使用2次。用于五一、十一或司庆前的员工动员会。
动员大会费用标准	动员大会费用标准：<>A+、A类分部：12000<>B类分部：8000<>C类分部：6000
非常规节促慰问活动费介绍	非常规节促慰问活动费：<>非常规节促慰问活动费含在文体活动费中，每半年可使用2次。本费用可用在公司除五一、十一及司庆以外的非常规节促前后，如全国超级福利日举办员工慰问活动使用。
非常规节促慰问活动费标准	非常规节促慰问活动费标准：<>总部：8000<>A+、A类分部：6000<>B类分部：4000<>C类分部：3000
非常规节促慰问活动费使用形式	非常规节促慰问活动费一般文体活动费用于组织运动会、球赛等体育活动或文艺比赛、动员会、大型慰问等活动，不得以现金形式发放或挪用；
员工大会（年会）费用使用范围	员工大会（年会）费用使用范围：集团及各分部年会费用。包含住宿费、餐饮费、会场租赁费、车辆租赁费、交通费、支援人员出差补助、服装道具费、工作餐费、造型费用、外聘教练费用、视频制作费、制作费（印刷品、旗帜、宣传物、条幅、照片冲印、奖杯、徽章、道具制作等）、物资采购费（酒水、食品、药品、办公用品、电池等），资料邮寄费用、优秀员工奖励费用等；
员工大会（年会）费用使用标准	员工大会（年会）费用使用标准：<>年会期间产生的交通费、出差补助按照公司差旅费管理规定执行；<>大会基本费用（元）<>A+、A类分部：20000<>B类分部：16000<>C类分部：12000<>每个门店费用（元）<>A+、A类分部：800<>B类分部：700<>C类分部：600
员工大会（年会）费用使用形式	员工大会（年会）费用使用形式：<>由一级分部负责组织本分部年会使用，不得挪用。
防暑降温费适用范围	防暑降温费适用范围：<>防暑降温用品或食品采购费用（绿豆、花露水、风油精、毛巾、饮料、水果等）；
防暑降温费适用对象和标准	防暑降温费适用对象和标准：<>门店员工：门店库管、库工及门店驻店安保30元/人，门店一、二线自有员工25元/人；<>3C物流体系：各分部商品运营部、物流部部门所属库管、理货员30元/人；<>物流体系：部门所属员工（含库管、库工、办公室人员，自有调货车司机、物流部安保人员）、第三方物流公司的调度及配送人员30元/人；
防暑降温费使用形式	防暑降温费使用形式：<>由相应部门联合培训部进行防暑降温物品采购，及时进行发放，做好高温预警方案。
员工慰问费适用范围	员工慰问费适用范围：<>公司对员工给予的关心慰问产生的礼品，食品采买费
员工慰问费费用标准	员工慰问费费用标准：250元/次；	
员工慰问费费用使用对象	员工慰问费费用使用对象：<>入司后生产的女员工、生病住院员工、直系亲属(配偶、父母/养父母、配偶父母/养父母、子女、兄弟姐妹等)去世的员工；
员工慰问费费用使用形式	员工慰问费费用使用形式：<>由公司购买相关慰问品予以探望。
驻店员工费用适用范围	驻店员工费用适用范围：驻店员工房租、水电、煤气费、部分驻店生活物资采买费用等；其中驻店生活物资采买范围参照行政中心相关规定，其中可以从福利费中列支的项目仅包含篮球、羽毛球、拉力器、握力棒、哑铃、象棋等娱乐物资及棉大衣、棉帽、棉被、褥子等生活物资。
驻店员工费用标准	根据当地情况合理支出；	
驻店员工费用使用对象	驻店员工费用对象：<>全体驻店员工；
驻店员工费用使用形式	驻店员工费用使用形式：<>驻店生活物资按驻店人员数量实际配发，应清点驻店人员现有生活物资，不得重复购买，报废物品需满足报废年限。
加班餐费适用范围	加班餐费适用范围：<>公司员工因工作需要，在非工作时间加班的餐费补贴。
工作日加班餐费适用范围	工作日加班餐费适用范围：<>职能部门工作日加班至21:00之后可有享受加班餐费1次；
周末加班餐费适用范围	周周末加班餐费适用范围：<>六日及其他法定假日加班4小时-8小时可享受加班餐费1次，8小时以上可享受加班餐费2次；
非常规加班餐费适用范围	非常规加班餐费适用范围：<>如遇非常规节促如全国超级福利日，由于门店及门店支援人员、业务、营运体系工作紧张，在活动期内可享受每天2顿，不超过3天的加班餐补待遇。筹备期加班餐补参照工作日及周末加班餐。
新开店、大型节假日促销活动加班餐费适用范围	如遇新开店或大型节假日促销活动（如五一、十一）门店员工、财务、物流体系员工由于工作紧张，享有不超过7天的加班餐补待遇，具体见当期发文；报销时须提供当期发文文件作为报销附件；	
加班餐费使用标准	加班餐费使用标准：15元/人/次；
加班餐费使用形式	加班餐费使用形式：<>日常加班餐各部门自行报销，报销时需附打卡记录并在打卡记录上对加班日进行勾画，作为报销附件上传。大型节假日及非常规节促加班餐补由相应体系通知，并联合分部培训部进行人员核定及发放。
在职/收入证明如何获取	不包含薪酬信息的在职证明，需联系员工关系部出具（需说明用途）<>包含薪酬信息的在职/收入证明，需联系薪酬管理部出具（需说明用途）
离职证明如何获取	离职手续办理完结后一周内到员工关系部自行领取	离职手续办理完结的时间以哪个为准？
费控系统中手机费报销无法带出报销标准	1.在未审批的情况下更换浏览器，重新提报；<>2.如已审批被财务退回，则需结束流程，更换浏览器重新提报；<>3.更换浏览器后还无法带出报销标准的，请联系员工关系部。
报销手机费时提示：无相应报销标准	请联系员工关系部维护
报销手机费时提示：当前报销额度未发送至HCM，员工不能报销当月手机费	需在每月10日后于费控系统提报相关表单
当月离职人员手机费报销	手机话费标准进行定界处理：<>进入HCM系统打开PA30， 特批福利费标准定界 界面将开始日期修改为每月1日，选中要定界的福利费标准，点击定界 按钮。<>定界时间按照国美发（143）《关于调整大区、分部及门店人员手机费报销标准的通知》中规定：离职人员15 日前（含15 日）离职的，次月不予报销离职当月话费。15日以后离职的，可在次月报销离职当月话费。
特殊人员手机费报销	特殊人员报销类型：<>a．实习期、代理期、储备人员，按人资部门核定的相应职级进行报销。<>b．孕、产、病、事假人员，休假满一个自然月的，不予报销当月手机话费。<>2.特殊人员报销手机话费时间要求：<>a. 15 日前（含15 日）请假/因病产事假待岗的，次月不予报销当月话费；15 日以后请假的，可在次月报销当月话费。<>b. 15 日前（含15 日）终止请假/因病产事假待岗的，次月可予报销当月话费；15 日以后终止请假/待岗的，次月不予报销当月话费。
费控系统中申请加班餐费无相应标准	加班餐费系统中无需植入标准，可直接报销
提报费控显示:无法找到部门负责人	需联系信息中心处理，拨打4000701080
费控系统中差旅费无法带出报销标准	1.在未审批的情况下更换浏览器，重新提报；<>2.如已审批被财务退回，则需结束流程，更换浏览器重新提报；<>3.更换浏览器后还无法带出报销标准的，请联系员工关系部。
离职如何办理	手写离职申请交至人资员工关系部（或计划管理部）领取员工离辞职审批单、员工工作内容交接表、员工离职面谈表。同时线上作答离职问卷，提报oa员工异动离辞职交接单
人事正档存放	1.京藉员工到人资员工关系部领取介绍信自行前往北京市外商投资服务中心存放档案，待存放后将回执交回员工关系部。<>2.非京藉人员暂无法提供档案接收服务。
城市间调转会计证所需资料清单	联系员工关系部取得在职证明、营业执照副本复印件后自行办理	
怎么申请名片	持授权领导审批后的名片申请到员工关系部审核岗位，交至行政中心后勤服务部
怎么借阅档案	工作联系函（对公）或oa申请（对私）由授权领导审批后到员工关系部借阅
更换工牌	携带坏旧工牌到员工关系部领取
入职后域账号什么时候生成	入职后第三天生成域账号
SAP账号及初始密码规则	账号：姓名首写字母加六位入职时间<>初始密码：123456
员工自助系统（E激励系统）重置密码，提示“手机号码失败	联系员工关系部提供正确手机号码，更改后第二天再重置密码
员工自助系统（E激励系统）密码不正确	点击界面中的忘记密码，根据步骤提示进行重置
兼职岗位系统账号	原SAP账号后加-1
个人信息发生变化（家庭住址、通讯方式）	联系员工关系部提供正确信息
系统中年假时数不准确	需提供历年社保对账单，交至员工关系部修改年假起算日期。
HCM初始密码是什么	HCM初始密码：<>用户密码：123456，登陆口令：姓名首写字母加六位入职时间。如果忘记登陆密码，需要登陆员工自助系统，通过修改密码功能生成随机密码发送您绑定的手机号。再次登陆系统，需要重新设置密码。
提示HCM系统账户被锁定	账户锁定问题，可以尝试一下操作：<>登陆OA系统，使用“应用系统账号解锁申请表 ”表单解锁
提示HCM系统密码已过期	"原因是长时间未登陆账户，导致密码失效；<>解决办法：使用员工自助系统重置密码；
营业员转促销员如何操作	操作事务码PA30：组织分配工资范围改为“99不核算”，开始日期改为员工营业员转促销员日期的次月的1号，如:某员工2015.11.15由营业员转为促销员，则组织分配开始日期为2015.12.01。
促销员转营业员如何操作	操作事务码PA30：组织分配工资范围改为所在单位的工资核算范围,开始日期改为员工促销员转营业员日期的当月的1号，如某员工2015.11.15由促销员转为营业员，则组织分配开始日期为2015.11.01。
分部员工招聘条件中学历和年龄标准	（一）学历要求<>1．位于三至六线城市的门店，除安保、司机、库工、理货员等岗位外，其他基层岗位应招聘普通高中及以上学历人员，优先招聘职业高中、中专等接受过职业技能教育或大专以上接受过高等教育学习的人员，其中，营业员岗位大专及以上学历人员在新入职人员中的占比不低于50%。<>2．位于一二线城市的门店，除安保、司机、库工、理货员等岗位外，其他基层岗位应招聘大专以上接受过高等教育或中专、职业高中等接受过职业技能教育学习的人员，其中大专及以上学历人员在新入职人员中的占比不低于50%（营业员和非营业员分类统计）。<>3．为促进门店新业务的发展，智能专区门店营业员的招聘，应优先招聘大专及以上学历人员，同时可根据门店所在城市人才供给情况招聘少数普通高中、职业高中或中专学历的人员，但大专及以上学历人员在新入职智能专区营业员中的占比不低于80%。<>4．新招聘的店长、经理级人员学历要求是大专或以上学历。<>（二）年龄要求<>1．招聘门店一线岗位人员，年龄要求为30周岁以下，但对于综合素质较好且同岗位工作经验5年以上的人员，经分部总经理特批年龄可放宽至35周岁，但特批人员在门店一线岗位新入职人员中的占比不超过10%；<>2．招聘行政司机岗位人员，年龄要求为28至40岁之间；<>3. 招聘分部副总经理及以下高管岗位人员，年龄要求为，男性45周岁以下，女性40周岁以下；招聘分部经理及店长岗位人员，年龄要求为40周岁以下。
如何查询自己的社保缴费记录	登录北京社会保险网上服务平台官网--点个人用户登录—注册账号—登录—进行个人权益定制查询，隔天生效。
如何更改手机号	将新手机号写在复印好的身份证复印件上，交给辛潮更改，隔天生效，每月5-25号办理此项业务。
如何更改定点医疗机构	将要更改的医院名称及代码（可以百度查询）写在复印好的身份证复印件上，交给辛潮更改，隔天生效，每月5-25号办理此项业务。
如何更改户口性质（缴费人员类别）	将户口本原件、身份证复印件，交给辛潮，去社保局办理变更。
如何更改职工身份	将劳动合同，岗位协议或聘任材料等原件复印件，交给辛潮，出具单位证明到社保局办理。
如何办理异地就医登记及变更	1.填写异地定点医疗机构登记表（社保网站下载或跟辛潮要表），在外地选择两家定点医院，注明医院级别并加盖医院公章，异地医保部门加盖章，单位意见加盖章；2.将盖好医院和医保部门章的登记表和个人社保卡交给辛潮处理。
领到的社保卡与本人身份证信息不一致怎么办？	请领卡后认真核对以下信息：<>a持卡人姓名、性别、民族、出生日期、身份证号码，有错误的，需将本人社保卡和二代身份证复印件交至人资。<>b持卡人照片有误的，需将本人社保卡及本人1寸白底彩色的证件照（1张），统一交交至人资。"	
到哪儿能查询社保卡内信息？	到卡服务网点（街道社保所和区县社保中心）、定点医疗机构自助终端查询机上自助查询，社保卡如遇问题可拨打咨询电话96102。
查询卡内信息时需要输入密码吗？密码是什么?	需要。初始查询密码为本人社会保障卡的后六位。
在哪儿修改社保卡密码？	可到卡服务网点修改，在自助终端机上自助修改，拨打社保卡服务热线12333自助语音服务进行修改。
查询密码忘了怎么办？	到社保卡服务网点办理密码重置。
社保卡丢了怎么办？	挂失（挂失分预挂失和正式挂失）。<>预挂失有三种方式：10天内有效<>a可拨打社保卡服务热线96102预挂失；<>b可在自助终端电子触摸屏自助预挂失；<>c可到卡服务网点办理书面预挂失。<>正式挂失：带本人身份证原件及复印件到卡服务网点办理。
如何撤销预挂失？	带持卡人的社保卡及身份证，在预挂失10天内到卡服务网点办理。
到哪儿办理补卡？	带本人的身份证原件和复印件，到卡服务网点办理，收取工本费20元。
到哪儿换卡？	需带原社保卡和持卡人身份证原件及复印件，到卡服务网点办理<>（领取新补（换）卡：持卡服务网点打印的《领卡证明》及本人身份证领取）
陪产假的适用范围	陪产假的适用范围：<>申请类型：公假  时间：10（顺产）-15（难产）天，自然日带薪假期 需要资料：结婚证 小朋友出生证明 医院相关生产证明
产假的适用范围	产假的适用范围：<>申请类型：产假  时间：128天（顺产），难产+15天，双胞胎+15，自然日计算，薪资与生育津贴核算。需要资料：结婚证；小朋友出生证明；医院相关生产证明；难产假申请需医生出示建议全修难产假”的相关证明。
病假的适用范围	病假的适用范围：<>申请类型：病假  时间：1天（按照实际情况无条件），1天以上（每年累计病假最多3个月），自然日计算，薪资扣减50%每日。需要资料：医院正规病假条（需加盖清晰公章、写明建议休息天数）；1个月以上的病假不认可私人医院开具的病假条。"	
公假的适用范围	公假的适用范围：<>申请类型：公假 申请条件：产检、开家长会、法院出席等 时间：每次最多4小时，自然日带薪假期 需要资料：医院相关产检证明 挂号凭条等。
年假的适用范围	年假的适用范围：<>问题：没有年假   解决办法：联系员工关系同事核对年假起算日期---人资中心考勤员推送年假（年假计算方法:（天数*8小时/12个月）*月数）  使用期限：1年半  是否可以延期：不一定。
指纹打不上卡	指纹打不上卡原因：岗位调整；手指脱皮；异动调入；其他   解决办法：出现第一次打卡失败请及时联系 人资中心 考勤专员：杨晶54,59288206
如何申请考勤密码打卡	如何申请考勤密码打卡：<>原因：手指严重脱皮无法指纹打卡，申请使用密码打卡。流程：提报OA文件报批单申请（与请假授权相同，最后一级是总部人资中心考勤员）---审批完成后打印下来至人资中心1202考勤员工位进行登记，并领取密码---有效期为1个月最长。


